Beginner :
my
hi - shortned word for hello
go - 
cab - american word for taxi 
jab -  
bat - animal that comes out in the dark
cat - animal that goes meow
fat - what happens when you eat too much 
hat - what goes on your head 
mat - somethng that goes on the floor
pat - when the dog is good you __ it 
rat - scary small animal that lives in floors
gas - something smelly and what you cook with
ham - what you can have on your sandwhich
jam - something you have on toast
cap - something you wear on your head
gap - when there is a big space there is a ___
lap - when you have ran around the field you have done one ___
map - what you use when your lost
nap - when you have a short sleep you have a ___
tap - what you use to wash your hands 
bag - you have this to take your stuff around with you 
lag - when your game freezes
tag - a game you play as a kid
wag - what happens when the dog is happy
ban -
can - what you can drink out off
fan - when you are too warm you can turn on a ___
man - if your not a woman you are a ___
pan - what you use to cook with
ran - someone chased me so I ___ away
tan - when its warm your skin gets a ___
van - a big white car is called a ___
bad - I got in trouble because I was ___
dad - I have a mum and a ___
had - The past tense of has
mad - When someone annoys me I get really ___
sad - If I am not happy then I am ___
bed - What you sleep in 
fed - I am really full because I have just been ___
red - The colour your cheeks go when your embarassed
den - You can make these in your room when your having a sleepover
men - In the olden days when the women cooked and cleaned the ___ went to work
beg - What homeless people do 
leg - You have two of these that help you walk
pen - What tou can use to write with 
ten - six,seven,eight,nine,___,eleven
get - If your naughty you ___ a smack in the face 
jet - a really fast plane
let - can you please ___ me stay over ?
met - the past tense of meet 
net - to catch the fish you need a ___
pet - if you keep an animal in your house its called a ___ 
vet - when your pet is poorly it must go to the ___
wet - it was raining outside so I got really ___
dog - a mans best friend 
rob - CIS1111 module leader is called ___ ;)
sob - when your upset you have a big ___
cop - the american version of a policeman
hop - when you stand on one leg and jump
job - you need this to earn money 
mop - what you clean the floor with 
pop - the american word for fizzy drinks 
top - what you wear on your chest
cot - what babys sleep in 
dot - there is a common game called ___ and crosses 
got - the past tense of get 
hot - the opposite of cold 
fog - when the clouds are low and you cant see anything there is ___
pot - something you use to cook with
jog - faster than a walk but slower than a run 
log - a word for a big piece of wood 
not - rhymes with 'got' but starts with a 'n'
rot - when you leave something for too long it starts too ___
hug - when someone is sad you give them a ___
sit - when you stand for too long you have to ___ down
bin - something you put rubbish in 
lip - when you kiss you touch ___
six - four,five,___,seven...
kid - if you are not an adult you are a ___
stop - what word does the lollipop pan have on his sign 
boat - what you go on to travel across the sea 
cold - if you are not hot you are ____
gold - something expensive that miners try to find 
hope - dont give up yet, there us still ____
bush - on fortnite defaults hide in a ____
goat - the bilys ____ gruff
home - where you live 
feed - when you get up in the morning you must ____ the dog
hood - what you put over your head when its cold 
fish - what tropical small pets you can have 
hand - Horrid Henry has the purple ____ gang 
rock - this is a type of music. 
jail - if you are bad then you go to ____
good - if your not bad then you are ____
card - on valentines day you normally send a ____
king - Prince Charles will be the next ____ of England 
land - if your not on water, you are on ____
bear - this animal lives in the woods and is really big 
foot - we have two of these and its what we stand on 
Intermediate: 
area - my local ____ has a shop 
army - a group of people who fight to protect our country 
away - when you want to get rid of someone you tell them to go ____
baby - when we are first born we are a ____
ball - when you play football you need a ____
bath - this is when you take a longer shower 
belt - this helps stop your trousers from falling down 
bird - these animals fly in the sky 
blue - this is the colour of the sea and sky 
bowl - if you dont eat from a plate, you eat from a ____
bomb - if you blow something up you use a ____
cash - the american word for money 
cold - if you your not hot then you are ____
dark - if its not light outside then it must be ____
dead - when the fish isnt moving at the bottom of the cage then it must be ____
date - what a good idea. Lets set a ____ to go 
door - when you go into a room, you must walk through the door 
face - you have a very punchable ____
farm - where lots of animals live 
four - one, two, three, ____, five 
girl - if your not a boy then you are a ____
golf - when you hit a ball with a stick into a hole in the ground.
game - at playtime we can play a ____
hair - what you have on your head 
home - where you live 
keep - " ive found a penny on the floor! Can I ____ it ?"
lake - a small river 
love - when you really really like someone you ____ them 
luck -  when you want someone to do well you say good ____
long - if its not small then it is ____
milk - you put this in a ceral 
name - when you want to find out what someone is called you ask for their ____
pink - traditionally a girls favourite color 
rain - what we always get in the UK 
sand -  when you go to the beach, there is lots of ____
talk - when you speak to someone you ____ to them 
twin - when you are born at the same time you are ____
week - 7 days is also known as one ____
zero - ____, one, two, three 
abuse - when you are constantly nasty to soemone you give them _____
actor - a job you do when you act
Angle - a sqaure has four right _____  
angry - the opposite of happy 
badly - "wow i did really _____ in that test"
bench - in football when you are subbed off you go on the _____
bread - what do you put in the toaster ?
brain - to think you have to use your _____
brown - the colour of a branch on a tree is  ____
clock - what you use to tell the time 
crown - every king and queen has one 
drink - when you eat, you wash it down with a _____
every - a common saying is "_____ cloud"
fresh - when someone is new it is _____
glass - what you drink out of and can smash 
great - if something is good then it is _____
happy - if your not sad then your _____
sweet - the opposite of chocolate 
sugar - you get diabetes if you have too much
teeth - when you go the dentist they inspect your _____
train - how you travel fast across the country 
truth - shall we play the game _____ or dare ?
video - dont take a photo, take a _____ instead
Expert:
Active - if your not lazy then you are ______
Amount - the ______ comes too Â£7.45
Holder - I am a merlin pass ______
Leaves - what falls on the ground in autumn
Lesson - " I have a maths ______ first"
Moment - 
Moving - "Today I am ______ house"
Period - Lets watch a ______ drama 
Police - They keep our streets safe 
Relief - When you feel better about something 
Stream - When you watch something live 
Writer - People use to use type ______
Advised - When Borris Johnson makes decisions he is _______
History - A subject at school 
However - A connective word
Kitchen - Where you cook the food 
Library - Where you read books 
Listing - When you create a list you are _______
Morning - The opposite of afternoon 
Opinion - If you have a belief about something you have a _______
Problem - When something occurs that is bad it is known as a _______
Recover - When you have done something hard you need to _______
Sixteen - Fourteen, Fifteen, ________, Seventeen 
Tension - When people are not happy there is _______
Vehicle - What you use to get around 
Winning - The opposite of losing 
Working  - What you have to do to earn money 
Accepted - The opposite of rejected 
Achieved - When you have done something good and you earn a reward. You have ________ something
Building - What most houses are 
Calendar - What you have that tells you many days in the year 
Capacity - When somewhere is full it is at ________
Daughter - If yoour not a son then you are a ________
Describe - When you tell someone about something you ________ it 
Eighteen - Sixteen, Seventeen, ________, Nineteen
Finished - The opposite of started
Hospital - When you are very poorly you go to ________
Inspired - When someone has told you something good you have ________ them 
Medicine - When you are poorly this makes you better 
Notebook - What you write in to make notes 
Operator - At a theme park this person starts the rides 
Powerful - If you are not weak thne you are _________
Research - If you are interested in something you can conduct further ________
Security - At a concert there are lot's of ________
Simplify - On the gameshow the CHASE if the game is too hard then you must ________
Terrible - If something is really bad then it is ________
Violence - If there is alot of physical fighting then there is a lot of ________
Wireless -  If something isn't wired then it is ________
Yourself - When you are selfish you only think about ________
Chocolate - The opposite of sweets 
Christmas - What comes on the 25th of December ?
Beautiful - The opposite of ugly 
Happiness - The opposite of sadness
Adventure - If you want to go exploring this is known as an _________
Irregular - The opposite of regular 
President - This role is the leader of America 
Adjective - This type of word describes something 
Different - If something isn't the same then it is _________
Vegetable - 'You must eat your fruit and ________'
Invisible - When someone can't see you, you are _________
Education - What you must go through to learn new things 
Beginning - The opposite of the end 
Wednesday - Monday, Tuesday, _________, Thursday 
Breakfast - What you eat at the start of the day 
Chemistry - The three types of science are Biology, Physics and _________
Celebrity - Ant and Dec host I'm a _________ get me out of here !
Breathing - You must do this to live 
Girlfriend - The opposite of a boyfriend 
Earthquake - When the ground shakes it is known as an __________
Concussion - What happens when you badly bang your head 
Instrument - What you play to create music 